11111111111
100C00100E1
1000000C011
1P000C00001
11111111111
