11111111111
100000100E1
11110000011
1P0C0000001
11111111111
