11111111111111111111
10C000100000000100E1
11110000010001111111
1P0C0000000000010C01
100000001C0000000001
11111111111111111111
